10
9
--s#h#h-#
k###---##
-#d--#-d-
-###-#-#k
---d---##
-h##h#--#
-##-##-##
-d--#h--d
###-##-#-
#h-d---#e
