11
14
-k##----#--d--
-##ed#-#--###-
-d-##----##---
##h#-####h--#-
#--#---####-#-
-d#h-#--#-d#--
h##-##-##-#--#
---h#---d-#-#-
###-##d-s-#-#k
#h-----#---d-h
#--#-##--d--##